_W_________________
_W___WWWWWWWWWWWWW_
W_W_W_____________W
W__W______________W
W________________BW
W_______________BBW
W_WWW____P___WB_WW_
W_W_W____W__WWWWW__
W_W_WB__WW__W______
WDW_WWWWWWBWW______
WWW_WW___WWW_______
