_W_________________
_W___WWWWWWWWWWWWW_
W_W_W_____________W
W__W______________W
W____________P____W
W___________B_____W
W_WWW_______BW_BWW_
W_W_W____W_BWWWWW__
W_W_W___WW_BW______
WDW_WWWWWWBWW______
WWW_WW___WWW_______
