_W_________________
_W___WWWWWWWWWWWWW_
W_W_W_____________W
W__W______________W
W________________BW
W_______________BBW
W_WWW________WB_WW_
W_W_W__P_W__WWWWW__
W_W_WBB_WW__W______
WDW_WWWWWW_WW______
WWW_WW___WWW_______
