_W_________________
_W___WWWWWWWWWWWWW_
W_W_W_____________W
W__W______________W
W_________________W
W_________________W
W_WWW___BP__BW__WW_
W_W_W____W__WWWWW__
W_W_WB__WWBBW______
WDW_WWWWWWBWW______
WWW_WW___WWW_______
