_W_________________
_W___WWWWWWWWWWWWW_
W_W_W_____________W
W__W______________W
W____________B____W
W___________BP____W
W_WWW_______BW__WW_
W_W_W____W_BWWWWW__
W_W_W___WW_BW______
WDW_WWWWWWBWW______
WWW_WW___WWW_______
