_W_________________
_W___WWWWWWWWWWWWW_
W_W_W_____________W
W__W______________W
W________________BW
W_______________BBW
W_WWW_____B__WB_WW_
W_W_W____W__WWWWW__
W_W_W___WWP_W______
WDW_WWWWWWBWW______
WWW_WW___WWW_______
