_W_________________
_W___WWWWWWWWWWWWW_
W_W_W_____________W
W__W______________W
W________________BW
W________B______BBW
W_WWW____P___WB_WW_
W_W_W____W__WWWWW__
W_W_W___WW__W______
WDW_WWWWWWBWW______
WWW_WW___WWW_______
