_W_________________
_W___WWWWWWWWWWWWW_
W_W_W_____________W
W__W______________W
W_________________W
W_________________W
W_WWW__B_____W__WW_
W_W_W___BW__WWWWW__
W_W_WB_PWWBBW______
WDW_WWWWWWBWW______
WWW_WW___WWW_______
