_W_________________
_W___WWWWWWWWWWWWW_
W_W_W_____________W
W__W______________W
W_________________W
W_________B_______W
W_WWW_______BW__WW_
W_W_W____WPBWWWWW__
W_W_W___WWBBW______
WDW_WWWWWWBWW______
WWW_WW___WWW_______
