_W_________________
_W___WWWWWWWWWWWWW_
W_W_W_____________W
W__W______________W
W_________________W
W_________________W
W_WWW_____P_BW__WW_
W_W_W____W_BWWWWW__
W_W_WB__WWBBW______
WDW_WWWWWWBWW______
WWW_WW___WWW_______
