_W_________________
_W___WWWWWWWWWWWWW_
W_W_W_____________W
W__W______________W
W________________BW
W_______________BBW
W_WWW________WB_WW_
W_W_W__B_W__WWWWW__
W_W_W__PWW__W______
WDW_WWWWWWBWW______
WWW_WW___WWW_______
