_W_________________
_W___WWWWWWWWWWWWW_
W_W_W_____________W
W__W__________B___W
W_________________W
W_____________PB__W
W_WWW_______BW_BWW_
W_W_W____W__WWWWW__
W_W_W___WW_BW______
WDW_WWWWWWBWW______
WWW_WW___WWW_______
